12
6
7
#######
# #X X#
#E#   #
#  C#C#
#     #
#######

